    MMMMM
    MSSSM
    MSSSM
  MMMSSSMM
  MSSSSSSM
MMMSMSMMSM   MMMMMM
MSSSMSMMSMMMMMSSXXM
MSSSSSSSSSSSSSSSXXM
MMMMMSMMMSMSMMSSXXM
    MSSSSSMMMMMMMMM
    MMMMMMM
